{ 
    "level": [
        "--------------------",
        "--------------------",
        "--------------------",
        "---XXXXX------------",
        "--------------------",
        "--------------------",
        "-----------XXXXX----",
        "---------------X----",
        "---------------XXXXX",
        "---XXXXX------------",
        "--------------------",
        "-----------------P--",
        "XX----------XXXXXXXX",
        "XX----------XXXXXXXX",
        "XXXX---XXXXXXXXXXXXX"
    ]
}